########
#   #  #
#   $$ #
# ##   #####
#   @ ##   #
## ####    #
#         .#
############
